5 5 5 5 5 5 5 5 5 5 5 5 5 5 5 5 5 5 5 5 5 5 5 5 5 5 5 5 5 5 5 5 5 5 5 5 5 5 5 5 5 5 5 5 5 5 5 5 5 5 
5 5 5 5 5 5 5 5 5 20 21 21 21 21 21 21 22 5 5 5 5 5 5 5 5 5 5 5 5 5 5 5 5 20 21 21 21 21 21 21 21 21 21 21 21 21 21 21 21 21 
5 5 5 5 5 5 5 5 5 23 0 0 0 0 0 0 24 5 5 5 5 5 5 5 5 5 5 5 5 5 5 5 20 31 0 0 0 0 0 0 0 0 0 0 0 0 0 0 0 0 
5 5 5 5 5 5 5 5 5 23 0 0 0 0 0 0 24 5 5 5 5 5 5 5 5 5 5 5 5 5 5 20 31 0 0 0 0 0 0 0 0 0 0 0 0 0 0 0 0 0 
5 5 5 5 5 5 5 5 5 23 0 0 0 0 0 0 24 5 5 5 5 5 5 5 5 5 5 5 5 5 20 31 0 0 0 0 0 0 0 0 44 47 45 46 0 0 0 0 0 0 
5 5 5 5 20 21 21 21 21 31 0 0 0 0 0 0 24 5 5 5 5 5 5 5 5 5 20 21 21 21 31 0 0 0 0 0 44 45 46 3 56 58 59 58 0 0 0 0 0 0 
5 5 5 5 23 0 0 0 0 0 0 0 0 0 0 0 24 5 5 5 5 5 5 5 5 20 31 0 0 0 0 0 0 0 0 3 72 74 75 3 72 84 85 75 79 0 0 0 0 0 
5 5 5 5 23 0 0 0 0 0 0 0 0 0 0 0 30 21 21 21 21 21 21 21 21 31 0 0 0 0 0 0 0 0 3 3 3 108 79 3 3 3 108 3 3 3 3 3 3 0 
5 5 5 5 23 0 0 0 0 0 0 0 0 0 0 0 0 0 0 0 0 0 0 0 0 0 0 0 0 0 0 0 0 0 93 93 93 32 3 3 3 3 32 3 3 3 3 3 3 0 
5 5 5 5 23 0 0 0 0 0 0 0 0 0 0 0 0 0 0 0 0 0 0 0 0 0 0 35 33 33 33 36 0 0 93 93 93 32 3 3 3 3 32 3 48 51 49 49 50 0 
5 5 5 5 23 0 0 0 0 0 0 0 0 0 0 0 0 0 0 0 0 0 0 0 0 0 0 32 39 88 39 32 0 0 3 3 3 32 3 3 3 3 32 3 60 61 63 61 62 0 
5 5 5 5 23 0 0 0 0 0 0 0 0 0 0 0 0 0 0 0 0 0 0 0 0 0 0 32 39 89 39 101 33 33 33 33 33 34 33 33 33 33 37 0 72 73 84 73 75 0 
5 5 5 5 23 0 0 0 0 0 0 0 0 0 0 0 0 0 0 0 0 0 0 0 0 0 0 32 39 39 39 32 0 0 0 0 3 32 3 3 3 0 3 79 72 84 85 84 75 0 
5 5 5 5 23 0 0 0 0 0 0 0 0 0 0 0 0 0 0 0 0 0 0 0 0 0 0 38 33 33 33 37 0 0 0 0 3 34 33 33 33 33 33 33 33 33 37 3 3 0 
5 5 5 5 25 26 26 26 26 29 0 0 0 0 0 0 0 0 0 0 0 0 0 0 0 0 0 0 0 0 0 0 0 0 0 0 3 32 3 3 3 3 48 49 49 49 51 50 93 93 
5 5 5 5 5 5 5 5 5 23 0 0 0 0 0 0 0 0 0 0 0 0 0 0 0 0 0 0 0 0 0 0 0 0 0 0 3 32 3 3 3 3 60 63 61 61 61 62 93 93 
5 5 5 5 5 5 5 5 5 23 0 0 0 0 0 0 0 0 0 0 0 0 0 0 0 0 0 0 0 0 0 0 0 0 0 0 3 32 3 53 3 79 72 85 84 73 84 75 93 93 
5 5 5 5 5 5 5 5 5 23 0 0 0 0 40 41 41 41 41 41 41 41 41 41 41 41 41 41 41 42 0 0 0 0 0 0 3 32 3 53 3 3 3 108 3 3 3 3 3 0 
5 5 5 5 5 5 5 5 5 23 0 0 0 0 54 3 3 3 3 3 3 3 3 3 39 3 3 3 3 55 0 0 0 0 0 0 3 32 3 3 3 3 3 32 3 3 88 3 0 0 
5 5 5 5 5 5 5 5 20 31 0 0 0 0 54 3 3 3 3 39 3 96 39 39 3 95 3 39 39 55 0 0 0 0 39 39 39 32 3 3 3 3 3 32 3 3 89 3 0 0 
5 5 5 5 5 5 5 5 23 0 0 0 0 0 54 3 3 3 39 3 3 95 3 3 3 95 3 3 39 55 0 0 0 0 98 39 39 101 33 33 33 33 33 34 33 33 107 3 0 0 
5 5 5 5 5 5 5 5 23 0 0 0 0 0 54 3 39 3 39 3 3 95 3 39 3 97 3 3 3 55 0 0 0 0 39 39 39 32 3 3 3 3 3 32 3 3 3 3 0 0 
5 5 5 5 5 19 19 19 19 33 33 102 33 33 107 3 3 3 3 94 94 97 3 94 94 3 3 39 39 55 0 0 0 0 39 88 39 32 3 3 3 3 3 32 3 3 3 3 0 0 
5 5 5 5 5 5 5 5 23 3 3 32 3 3 54 3 39 39 3 3 3 3 95 3 3 3 3 96 39 55 0 0 0 0 39 89 39 32 3 3 3 40 41 109 41 42 3 3 0 0 
5 5 5 5 5 5 5 5 23 3 3 32 3 3 54 3 3 3 3 3 3 3 97 3 39 39 3 95 39 55 0 0 0 0 93 93 39 32 3 3 0 52 39 39 39 52 0 0 0 0 
5 5 5 5 5 5 5 5 23 3 3 32 3 3 54 3 3 3 3 94 94 3 39 39 3 3 3 95 39 55 0 0 0 0 39 39 39 32 3 3 0 52 39 94 39 52 0 0 0 0 
5 5 5 5 5 5 5 5 23 3 3 32 3 3 54 3 3 39 3 3 3 39 39 3 3 97 3 97 39 55 0 0 0 0 0 39 39 32 3 3 0 52 39 39 39 52 0 0 0 0 
5 5 5 5 5 5 5 5 23 3 3 32 3 3 54 3 3 3 3 39 39 39 3 3 3 3 39 3 3 55 0 0 0 0 0 0 98 32 3 3 0 64 41 41 41 66 0 0 0 0 
20 21 21 21 21 21 21 21 31 3 3 32 3 3 64 41 41 41 41 41 41 41 41 41 41 41 41 41 41 66 0 0 0 0 0 0 0 32 0 0 0 0 0 0 0 0 0 0 0 0 
23 3 3 3 3 3 3 3 3 3 3 32 3 3 0 0 0 0 0 0 0 0 0 0 0 0 0 0 0 0 0 0 0 0 0 0 0 32 0 0 0 0 0 0 0 0 0 0 0 0 
23 3 3 3 0 0 0 0 0 0 0 32 0 0 35 33 33 33 33 102 33 33 33 33 33 33 33 33 33 33 102 33 33 33 33 33 33 37 0 0 0 0 0 0 0 0 0 0 0 0 
23 3 3 0 0 0 0 0 1 1 1 1 1 1 1 0 0 3 3 32 28 26 26 26 26 26 26 26 26 29 32 0 0 0 0 0 0 0 0 0 0 0 0 0 0 0 1 1 70 0 
23 3 3 0 0 0 1 1 1 1 1 1 1 1 1 1 0 3 3 32 24 5 5 5 5 5 5 5 5 23 32 0 0 0 0 0 0 0 0 0 0 0 0 0 0 1 1 1 1 0 
23 3 3 0 0 1 1 1 1 1 1 1 1 70 1 1 0 3 3 32 24 5 5 5 5 5 5 5 5 23 32 0 0 0 0 0 0 0 0 0 0 1 1 1 1 1 1 1 1 0 
23 3 3 0 0 1 1 70 1 1 1 1 1 1 1 1 0 0 3 32 24 5 5 5 5 5 6 5 5 23 32 0 0 0 0 0 0 0 0 0 1 1 1 1 70 1 1 1 70 0 
23 3 3 0 35 1 1 1 1 1 1 1 1 1 1 0 0 0 3 32 24 5 5 6 5 5 5 5 5 23 32 0 0 0 0 0 0 0 0 1 1 1 1 1 1 1 1 1 1 0 
23 3 3 0 32 0 0 1 1 1 1 70 1 1 1 0 0 0 3 32 24 5 5 5 5 5 5 5 5 23 32 0 0 0 0 0 0 0 0 1 70 1 1 1 1 1 2 1 1 0 
23 3 3 0 32 0 0 0 1 1 1 1 1 1 0 0 0 0 3 32 24 5 5 5 5 5 5 5 5 23 38 33 33 33 33 33 33 33 33 33 1 1 1 1 1 1 70 1 1 0 
23 3 3 0 32 0 0 0 0 0 0 0 0 0 0 0 0 0 3 32 24 5 5 6 5 5 5 5 5 25 26 26 26 26 26 26 26 26 26 29 1 1 1 1 1 1 1 1 1 0 
23 3 3 0 32 0 0 0 0 0 0 0 0 0 0 0 0 0 3 32 24 5 5 5 5 5 5 5 5 5 5 5 5 5 5 5 5 5 5 23 1 1 1 1 70 1 1 1 1 0 
23 3 3 0 32 0 0 3 91 53 3 53 3 0 0 0 0 0 3 32 24 5 5 5 5 20 21 21 21 21 21 21 22 5 5 5 5 5 20 31 0 1 1 1 1 1 1 1 70 0 
23 3 3 0 101 0 0 93 93 3 3 15 16 3 3 98 0 0 3 32 24 5 5 5 5 23 44 45 45 46 0 0 24 5 5 6 5 20 31 0 0 0 0 0 0 1 1 1 1 0 
23 3 3 0 32 0 98 93 15 16 3 17 18 3 3 3 98 0 0 32 24 5 5 5 5 23 68 69 70 71 53 90 24 5 5 5 5 23 35 33 33 33 33 33 33 33 1 1 1 0 
23 3 3 0 32 0 3 3 17 18 3 3 39 39 3 3 3 0 0 32 24 5 5 5 5 23 3 3 32 3 3 3 24 5 5 5 5 23 32 28 26 26 26 26 26 29 0 1 1 0 
23 3 3 0 32 0 3 39 39 3 39 39 3 39 3 98 3 0 35 34 19 19 19 19 19 19 33 33 37 3 3 3 24 5 5 5 20 31 32 24 5 5 5 6 5 23 0 0 1 0 
23 3 3 0 32 0 3 3 39 39 39 39 3 39 39 3 3 0 32 28 27 5 5 5 5 25 26 26 26 26 26 26 27 5 5 20 31 35 37 24 5 5 5 5 5 23 0 0 0 0 
23 3 3 3 32 0 3 3 39 39 3 39 3 39 3 3 98 0 32 24 5 5 5 5 5 5 5 5 5 5 5 5 5 5 20 31 35 37 28 27 5 5 6 5 5 23 0 0 0 0 
25 26 26 29 32 0 3 3 3 3 3 3 3 3 3 3 3 0 32 30 21 21 21 21 21 21 21 21 21 21 21 21 21 21 31 35 37 28 27 5 5 5 5 5 5 23 0 0 0 0 
5 5 5 23 38 33 33 33 33 33 33 33 33 33 33 33 33 33 100 33 33 33 33 33 33 33 33 33 34 33 33 33 33 33 33 37 28 27 5 5 6 5 5 5 5 25 26 26 26 26 
5 5 5 25 26 26 26 26 26 26 26 26 26 26 26 26 26 26 26 26 26 26 26 26 26 26 26 26 26 26 26 26 26 26 26 26 27 5 5 5 5 5 5 5 5 5 5 5 5 5 
